########## 
#.x.x#...# 
#...CC.P.# 
#........# 
########## 